XXXXXXX
P   X X
XXX X X
X X   X
X X X X
X   X E
XXXXXXX