XXXXXXXXXXX
P   X   X X
XXX X X X X
X X X X X X
X X X X X X
X   X X   X
XXX X X XXX
X   X X X X
X XXX X X X
X     X   E
XXXXXXXXXXX