XXXXXXXXXXXXXXXXX
P   X   X       X
XXX X X X XXXXX X
X X   X   X   X X
X XXXXXXXXX X X X
X       X   X X X
XXXXXXX X XXXXX X
X     X         X
X XXXXXXXXXXXXX X
X     X X     X X
XXX X X X XXX X X
X   X       X   X
XXXXXXX XXXXXXXXX
X       X   X   X
X XXXXXXX X X X X
X         X   X E
XXXXXXXXXXXXXXXXX