XXXXXXXXXXXXXXX
X X   XPXX    X
X   X    X XX X
XXXXXXXX X X  X
X        X X XX
XX XXXXX XX   X
X  X        X X
X XXX XXXX XXXX
X   X X EX X  X
X X X X X  X XX
X X X X X  X  X
X XXX X X XXX X
X   XXX X X   X
X X   X     X X
XXXXXXXXXXXXXXX