XXXXXXXXXX
X     X PX
X XXX XX X
X  X     X
X XX XXX X
X  X X X X
X    X X X
X XXXX X X
XE     X X
XXXXXXXXXX