XXXXXXXXX
P       X
XXXXXXX X
X     X X
X XXXXX X
X       X
XXXXXXX X
X       E
XXXXXXXXX