XXXXXXXXXX
XP    X  X
X XXX X XX
X  X     X
XXXXXXX XX
XX XEX   X
X  X   XXX
XX XXX X X
X        X
XXXXXXXXXX