XXXXXXXXXXXXXXX
X XP  X    X  X
X XXX X XXXXX X
X X X      X  X
X   XXXXX XX XX
XXX X         X
X     X XXX X X
XX XXXX   XXX X
X  X    X X   X
X XX XXXX X XXX
X    X  X     X
XXX XXX   XXX X
X X X XXX   X X
X      X  XEX X
XXXXXXXXXXXXXXX