XXXXXXXXXXXXXXX
P   X   X   X X
X X XXX X X X X
X X X   X X   X
XXX X XXX XXXXX
X   X         X
X XXXXXXX XXXXX
X     X       X
XXXXX X XXXXX X
X X   X     X X
X X XXXXXXXXX X
X X     X   X X
X XXX X X X X X
X     X   X   E
XXXXXXXXXXXXXXX