XXXXXXXXXXXXXXXXXXXXXXXXXXXXXX
X    X X X    X XX           X
X XX X   X XX X    XXXXXXX X X
X    XXX X  X XXXXXX       X X
X XX X   X XX      X XXXXXXX X
X  X   X X X  X XX   X     X X
XX X XXX   XX X XXXXXX X X X X
X  X   X XXXX X X      XXX X X
X XXXX X      XXX XX XXX   X X
X XX   X XX X  X    XXXXXX X X
X    XXX XX X XX X XX    X X X
XX X   X  X X    XXX  XX X X X
XXXXXX XXXXXXXXX     X X X X X
XX   X XX     XX X X X X XEX X
XX X X X  XXX X  XXXXX XXXXX X
XXXX X   XX   X XX         X X
XX   X X    X X    XXXXXXXXX X
XX XXX X XXXX X XX XX      X X
X     PX   X  X    X  XXXXXX X
X X XXXXXX X XX XXXX XX      X
X X      X X         X  XXXXXX
X XXX XX X X XXXX X XX X     X
X      X   X X  X X    X XXXXX
X XXXX X XXX XX X XX XXX   X X
X X XX    X     X    X XXX X X
X X X XXX X XXX   XXXX X   X X
X X X  XX X  X  XXX      X   X
X X X XX   X   XXX  XXX XX XXX
X   X    X   X     X         X
XXXXXXXXXXXXXXXXXXXXXXXXXXXXXX
