XXXXXXXXXXXXXXXXXXXX
X      X X   X X  EX
XXXX X X X X   X XXX
X   X  X X XX XX   X
X X X XP    XXXX X X
X X   X XXX      X X
X XXXXX X XXXXXXXX X
X X  X      X      X
X   XXXX XXXX XXXX X
X XXX            X X
X X   XX X XXXXX X X
X X XXX  X X   X X X
X   X   XX X XXX X X
X X X XXXX X X X X X
X X   X  X     X X X
XXX XXXX XXX XXX X X
X      X     X   X X
X XX X X XXXXX XXX X
X  X X X  X    X   X
XXXXXXXXXXXXXXXXXXXX