XXXXXXXXXXXXXXXXXXXXXXXXXXXXXX
XX X   X      X  XX   X   X XX
X    X   XX X XX  X X X X    X
X XXXXXXXXX X XXX X X X XXXX X
X X       X X X X X X X XX   X
X X XXXXX X X X X X X X  X XXX
X X X     X X       X X XX   X
X X X XXXXX XXXXXXXXX    XXX X
X X X               XXXXXX X X
X X XXXXXXXXXX XXXX        X X
X X               X XXXXXX   X
X XXXXXXX X XXXXX X      XXXXX
X       X X X   X X XXXX     X
X XXX X X X X X X X   XX XXXXX
X   X X X X XEX X XX X X     X
X X X X X X XXX X  X X XXXXX X
X X   X X X     X XX X    XX X
X XXXXX X XXXXXXX  X X X X   X
X              PXX   X X   XXX
X XXXXXXX XXXXXXX X XXXXXXXX X
X    X    X    XX X    X     X
XX X X XXXX XX X  X XX XXXXX X
X  X      X XX XX X    XX X  X
X XXXXX X X  X XX XXXXXX    XX
X     X  XXXXX     X   X XXXXX
X XXX X X     X XX X X X     X
X   X X X X XXX XXX  X XX XX X
X X X X X XXX       XX  X X  X
X             XXXXX  XX     XX
XXXXXXXXXXXXXXXXXXXXXXXXXXXXXX
