XXXXXXXXXXXXXXXXXXXX
XP   XX X      X   X
X XX  X X X XXXX X X
X   X X XXX X  X X X
X X X X X X XX     X
X X X     X    X XXX
X X   XXX  XXX X   X
X XXXXX XX X   X X X
X X     X  X X X X X
X   X X X X  X XXX X
X XXXXX X   XX     X
X  X X  XXXXXXXX XXX
X  X XX X          X
X XX X  X XXXX X X X
X    X XX X X XX X X
XXXXXX         XXX X
X      X XXXXX     X
X XXX XX X   XX XX X
X   X  X   X X  X EX
XXXXXXXXXXXXXXXXXXXX