XXXXXXXXXXXXXXXXXXXX
XP   X       X     X
XXXX X XXX X X XX XX
X    X     X   X   X
X XX XXXXX X XXX XXX
X  X         X     X
X XXXXX XXXX X X X X
X  X X       X XXX X
XX     X XXX X     X
XXXXXXX  X     X XXX
X       XX X XXX X X
X XX XX    X   X X X
X X   X XXXX X X   X
X XXX X    X X X X X
X  X   XXX   X X X X
XX   X     XXX X XEX
XXXXXX X X   X XXXXX
XX   X X XXX X X   X
X  X   X   X     X X
XXXXXXXXXXXXXXXXXXXX