XXXXXXXXXXXXXXXXXXXX
X      X       X   X
X XXXX P XXX X X X X
X  X X X X   X   X X
XX X   X XX XXXXXX X
X  X X X     X     X
X XX XXXXX X X XXXXX
X  X X X X X    X  X
X XX X X X XXXX X XX
X X        X       X
X XXXX X XXX X XXX X
X      X X   X     X
X XXXX X XXX X XXX X
X X X      X   XEX X
X X X X XX XXXXX X X
X     X  X X     X X
X XXX XX X X XXX   X
X  X   X X X X XXX X
XX   X   X X       X
XXXXXXXXXXXXXXXXXXXX