XXXXXXXXXXXXXXX
X   X   X     X
X X XXX X XXX X
X X X   X X   X
XXX   XXX X X X
X XXX   X   X X
X     X XXXEX X
XXXXXXX X XXX X
X    X        X
X XX   XXX XXXX
X  XX XX      X
X XPX    X XXXX
XXX X XX X X  X
X      X X   XX
XXXXXXXXXXXXXXX